9 9 9 9 9 9 9 9 9 9 9 9 9 9 9 9 9 9 9 9 9 9 9 9 9 9 9 9 9 9
9 9 9 9 9 9 9 9 9 9 9 9 9 9 9 9 9 9 9 9 9 9 9 9 9 9 9 9 9 9
9 9 0 0 0 0 0 0 0 0 0 0 0 0 0 0 0 0 0 0 0 0 0 0 0 0 0 0 9 9
9 9 0 0 0 0 0 0 0 0 0 0 0 0 0 0 0 0 0 0 0 0 0 0 0 0 0 0 9 9
9 9 0 0 1 2 0 0 1 2 0 0 1 2 0 0 1 2 0 0 1 2 0 0 1 2 0 0 9 9
9 9 0 0 1 2 0 0 1 2 0 0 1 2 0 0 1 2 0 0 1 2 0 0 1 2 0 0 9 9
9 9 0 0 1 2 0 0 1 2 0 0 1 2 0 0 1 2 0 0 1 2 0 0 1 2 0 0 9 9
9 9 0 0 1 2 0 0 1 2 0 0 1 2 0 0 1 2 0 0 1 2 0 0 1 2 0 0 9 9
9 9 0 0 1 2 0 0 1 2 0 0 1 2 3 4 1 2 0 0 1 2 0 0 1 2 0 0 9 9
9 9 0 0 1 2 0 0 1 2 0 0 1 2 3 4 1 2 0 0 1 2 0 0 1 2 0 0 9 9
9 9 0 0 1 2 0 0 1 2 0 0 1 2 0 0 1 2 0 0 1 2 0 0 1 2 0 0 9 9
9 9 0 0 1 2 0 0 1 2 0 0 1 2 0 0 1 2 0 0 1 2 0 0 1 2 0 0 9 9
9 9 0 0 1 2 0 0 1 2 0 0 1 2 0 0 1 2 0 0 1 2 0 0 1 2 0 0 9 9
9 9 0 0 0 0 0 0 0 0 0 0 1 2 0 0 1 2 0 0 0 0 0 0 0 0 0 0 9 9
9 9 0 0 0 0 0 0 0 0 0 0 1 2 0 0 1 2 0 0 0 0 0 0 0 0 0 0 9 9
9 9 1 2 0 0 1 2 2 2 0 0 0 0 0 0 0 0 0 0 1 2 2 2 0 0 1 2 9 9
9 9 3 4 0 0 1 2 2 2 0 0 0 0 0 0 0 0 0 0 1 2 2 2 0 0 3 4 9 9
9 9 0 0 0 0 0 0 0 0 0 0 1 2 0 0 2 2 0 0 0 0 0 0 0 0 0 0 9 9
9 9 0 0 0 0 0 0 0 0 0 0 1 2 2 2 2 2 0 0 0 0 0 0 0 0 0 0 9 9
9 9 0 0 1 2 0 0 1 2 0 0 1 2 2 2 2 2 0 0 1 2 0 0 1 2 0 0 9 9
9 9 0 0 1 2 0 0 1 2 0 0 1 2 0 0 1 2 0 0 1 2 0 0 1 2 0 0 9 9
9 9 0 0 1 2 0 0 1 2 0 0 1 2 0 0 1 2 0 0 1 2 0 0 1 2 0 0 9 9
9 9 0 0 1 2 0 0 1 2 0 0 1 2 0 0 1 2 0 0 1 2 0 0 1 2 0 0 9 9
9 9 0 0 1 2 0 0 1 2 0 0 0 0 0 0 0 0 0 0 1 2 0 0 1 2 0 0 9 9
9 9 0 0 1 2 0 0 1 2 0 0 0 0 0 0 0 0 0 0 1 2 0 0 1 2 0 0 9 9
9 9 0 0 1 2 0 0 1 2 0 0 0 1 2 2 2 0 0 0 1 2 0 0 1 2 0 0 9 9
9 9 0 0 0 0 0 0 0 0 0 0 0 1 0 0 1 0 0 0 0 0 0 0 0 0 0 0 9 9
9 9 0 0 0 0 0 0 0 0 0 0 0 1 0 0 1 0 0 0 0 0 0 0 0 0 0 0 9 9
9 9 9 9 9 9 9 9 9 9 9 9 9 9 9 9 9 9 9 9 9 9 9 9 9 9 9 9 9 9
9 9 9 9 9 9 9 9 9 9 9 9 9 9 9 9 9 9 9 9 9 9 9 9 9 9 9 9 9 9