9 9 9 9 9 9 9 9 9 9 9 9 9 9 9 9 9 9 9 9 9 9 9 9 9 9 9 9 9 9
9 9 9 9 9 9 9 9 9 9 9 9 9 9 9 9 9 9 9 9 9 9 9 9 9 9 9 9 9 9
9 9 0 0 0 0 0 0 0 0 0 0 0 0 0 0 0 0 0 0 0 0 0 0 0 0 0 0 9 9
9 9 0 0 0 0 0 0 0 0 0 0 0 0 0 0 0 0 0 0 0 0 0 0 0 0 0 0 9 9
9 9 0 0 1 2 0 0 1 2 0 0 1 2 0 0 1 2 0 0 1 2 0 0 1 2 0 0 9 9
9 9 0 0 1 2 0 0 1 2 0 0 1 2 0 0 1 2 0 0 1 2 0 0 1 2 0 0 9 9
9 9 0 0 1 2 0 0 1 2 0 0 1 2 0 0 1 2 0 0 1 2 0 0 1 2 0 0 9 9
9 9 0 0 1 2 0 0 1 2 0 0 1 2 0 0 1 2 0 0 1 2 0 0 1 2 0 0 9 9
9 9 0 0 1 2 0 0 1 2 0 0 1 2 3 4 2 2 0 0 1 2 0 0 1 2 0 0 9 9
9 9 0 0 1 2 0 0 1 2 0 0 1 2 3 4 2 2 0 0 1 2 0 0 1 2 0 0 9 9
9 9 0 0 1 2 0 0 1 2 0 0 1 2 0 0 1 2 0 0 1 2 0 0 1 2 0 0 9 9
9 9 0 0 1 2 0 0 1 2 0 0 1 2 0 0 1 2 0 0 1 2 0 0 1 2 0 0 9 9
9 9 0 0 1 2 0 0 1 2 0 0 1 2 0 0 1 2 0 0 1 2 0 0 1 2 0 0 9 9
9 9 0 0 0 0 0 0 0 0 0 0 1 2 0 0 1 2 0 0 0 0 0 0 0 0 0 0 9 9
9 9 0 0 0 0 0 0 0 0 0 0 1 2 0 0 1 2 0 0 0 0 0 0 0 0 0 0 9 9
9 9 2 2 0 0 1 2 2 2 0 0 0 0 0 0 0 0 0 0 1 2 2 2 0 0 1 2 9 9
9 9 4 4 0 0 1 2 2 2 0 0 0 0 0 0 0 0 0 0 1 2 2 2 0 0 3 4 9 9
9 9 0 0 0 0 0 0 0 0 0 0 1 2 0 0 2 2 0 0 0 0 0 0 0 0 0 0 9 9
9 9 0 0 0 0 0 0 0 0 0 0 1 2 2 2 2 2 0 0 0 0 0 0 0 0 0 0 9 9
9 9 0 0 1 2 0 0 1 2 0 0 1 2 2 2 2 2 0 0 1 2 0 0 1 2 0 0 9 9
9 9 0 0 1 2 0 0 1 2 0 0 1 2 0 0 1 2 0 0 1 2 0 0 1 2 0 0 9 9
9 9 0 0 1 2 0 0 1 2 0 0 1 2 0 0 1 2 0 0 1 2 0 0 1 2 0 0 9 9
9 9 0 0 1 2 0 0 1 2 0 0 1 2 0 0 1 2 0 0 1 2 0 0 1 2 0 0 9 9
9 9 0 0 1 2 0 0 1 2 0 0 0 0 0 0 0 0 0 0 1 2 0 0 1 2 0 0 9 9
9 9 0 0 1 2 0 0 1 2 0 0 0 0 0 0 0 0 0 0 1 2 0 0 1 2 0 0 9 9
9 9 0 0 1 2 0 0 1 2 0 0 0 1 2 2 2 0 0 0 1 2 0 0 1 2 0 0 9 9
9 9 0 0 0 0 0 0 0 0 0 0 0 1 96 97 2 0 0 0 0 0 0 0 0 0 0 0 9 9
9 9 0 0 0 0 0 0 0 0 0 0 0 1 98 99 2 0 0 0 0 0 0 0 0 0 0 0 9 9
9 9 9 9 9 9 9 9 9 9 9 9 9 9 9 9 9 9 9 9 9 9 9 9 9 9 9 9 9 9
9 9 9 9 9 9 9 9 9 9 9 9 9 9 9 9 9 9 9 9 9 9 9 9 9 9 9 9 9 9